07 10 10 26 10 10 10 09 09 10 10 10 26 10 10 09 00 00 00 00 00 00 00 00 00 00 00 00 00 00 00 00
09 33 11 26 11 33 33 09 09 33 33 11 26 11 33 09 00 00 00 00 00 00 00 00 00 00 00 00 00 00 00 00
09 34 26 26 26 34 34 09 09 34 34 26 26 26 34 09 00 00 00 00 00 00 00 00 00 00 00 00 00 00 00 00
09 26 26 26 26 26 26 09 09 26 26 26 26 26 26 09 00 00 00 00 00 00 00 00 00 00 00 00 00 00 00 00
43 40 26 26 26 26 26 09 09 26 26 26 26 26 41 43 00 00 00 00 00 00 00 00 00 00 00 00 00 00 00 00
43 39 26 26 26 26 26 09 09 26 26 26 26 26 42 43 00 00 00 00 00 00 00 00 00 00 00 00 00 00 00 00
09 26 26 26 26 26 26 09 09 26 26 26 26 26 26 09 00 00 00 00 00 00 00 00 00 00 00 00 00 00 00 00
09 26 26 26 26 26 26 09 09 26 26 26 26 26 26 09 00 00 00 00 00 00 00 00 00 00 00 00 00 00 00 00
09 26 26 26 26 26 26 09 09 26 26 26 26 26 26 09 00 00 00 00 00 00 00 00 00 00 00 00 00 00 00 00
09 26 26 26 26 26 26 09 09 26 26 26 26 26 26 09 00 00 00 00 00 00 00 00 00 00 00 00 00 00 00 00
09 26 26 26 26 26 26 09 09 26 26 26 26 26 26 09 00 00 00 00 00 00 00 00 00 00 00 00 00 00 00 00
09 26 26 26 26 26 26 09 09 26 26 26 26 26 26 09 00 00 00 00 00 00 00 00 00 00 00 00 00 00 00 00
09 26 26 26 26 26 26 09 09 26 26 26 26 26 26 09 00 00 00 00 00 00 00 00 00 00 00 00 00 00 00 00
07 08 08 08 08 08 08 07 07 08 08 08 08 08 08 07 00 00 00 00 00 00 00 00 00 00 00 00 00 00 00 00
00 00 00 00 00 00 00 00 00 00 00 00 00 00 00 00 00 00 00 00 00 00 00 00 00 00 00 00 00 00 00 00
00 00 00 00 00 00 00 00 00 00 00 00 00 00 00 00 00 00 00 00 00 00 00 00 00 00 00 00 00 00 00 00
00 00 00 00 00 00 00 00 00 00 00 00 00 00 00 00 00 00 00 00 00 00 00 00 00 00 00 00 00 00 00 00
00 00 00 00 00 00 00 00 00 00 00 00 00 00 00 00 00 00 00 00 00 00 00 00 00 00 00 00 00 00 00 00
00 00 00 00 00 00 00 00 00 00 00 00 00 00 00 00 00 00 00 00 00 00 00 00 00 00 00 00 00 00 00 00
00 00 00 00 00 00 00 00 00 00 00 00 00 00 00 00 00 00 00 00 00 00 00 00 00 00 00 00 00 00 00 00
00 00 00 00 00 00 00 00 00 00 00 00 00 00 00 00 00 00 00 00 00 00 00 00 00 00 00 00 00 00 00 00
00 00 00 00 00 00 00 00 00 00 00 00 00 00 00 00 00 00 00 00 00 00 00 00 00 00 00 00 00 00 00 00
00 00 00 00 00 00 00 00 00 00 00 00 00 00 00 00 00 00 00 00 00 00 00 00 00 00 00 00 00 00 00 00
00 00 00 00 00 00 00 00 00 00 00 00 00 00 00 00 00 00 00 00 00 00 00 00 00 00 00 00 00 00 00 00
00 00 00 00 00 00 00 00 00 00 00 00 00 00 00 00 00 00 00 00 00 00 00 00 00 00 00 00 00 00 00 00
00 00 00 00 00 00 00 00 00 00 00 00 00 00 00 00 00 00 00 00 00 00 00 00 00 00 00 00 00 00 00 00
00 00 00 00 00 00 00 00 00 00 00 00 00 00 00 00 00 00 00 00 00 00 00 00 00 00 00 00 00 00 00 00
00 00 00 00 00 00 00 00 00 00 00 00 00 00 00 00 00 00 00 00 00 00 00 00 00 00 00 00 00 00 00 00
00 00 00 00 00 00 00 00 00 00 00 00 00 00 00 00 00 00 00 00 00 00 00 00 00 00 00 00 00 00 00 00
00 00 00 00 00 00 00 00 00 00 00 00 00 00 00 00 00 00 00 00 00 00 00 00 00 00 00 00 00 00 00 00
00 00 00 00 00 00 00 00 00 00 00 00 00 00 00 00 00 00 00 00 00 00 00 00 00 00 00 00 00 00 00 00
00 00 00 00 00 00 00 00 00 00 00 00 00 00 00 00 00 00 00 00 00 00 00 00 00 00 00 00 00 00 00 00