09 10 10 10 10 10 27 28 28 29 10 10 10 10 10 09 09 10 10 10 10 10 27 00 00 00 00 00 00 00 00 00
09 11 11 11 11 11 30 31 31 32 11 11 11 11 11 09 09 11 11 11 11 11 30 00 00 00 00 00 00 00 00 00
09 04 03 04 03 04 03 04 03 04 03 04 03 04 03 09 09 04 03 04 03 04 03 00 00 00 00 00 00 00 00 00
09 03 02 01 02 01 02 01 02 01 02 01 02 01 02 09 09 03 02 01 02 01 02 00 00 00 00 00 00 00 00 00
09 04 01 05 01 02 05 02 01 05 01 02 05 02 01 09 09 04 01 05 01 02 05 00 00 00 00 00 00 00 00 00
09 03 02 06 02 01 06 01 02 06 02 01 06 01 02 09 09 03 02 06 02 01 06 00 00 00 00 00 00 00 00 00
09 04 01 02 01 02 01 02 01 02 01 02 01 02 01 09 09 04 01 02 01 02 01 00 00 00 00 00 00 00 00 00
09 03 02 05 02 01 05 01 02 05 02 01 05 01 02 09 09 03 02 05 02 01 05 00 00 00 00 00 00 00 00 00
09 04 01 06 01 02 06 02 01 06 01 02 06 02 01 09 09 04 01 06 01 02 06 00 00 00 00 00 00 00 00 00
09 03 02 01 02 01 02 01 02 01 02 01 02 01 02 09 09 03 02 01 02 01 02 00 00 00 00 00 00 00 00 00
09 04 01 05 01 02 05 02 01 05 01 02 05 02 01 09 09 04 01 05 01 02 05 00 00 00 00 00 00 00 00 00
09 03 02 06 02 01 06 01 02 06 02 01 06 01 02 09 09 03 02 06 02 01 06 00 00 00 00 00 00 00 00 00
09 04 01 02 01 02 01 02 01 02 01 02 01 02 01 09 09 04 01 02 01 02 01 00 00 00 00 00 00 00 00 00
09 03 02 05 02 01 05 01 02 05 02 01 05 01 02 09 09 03 02 05 02 01 05 00 00 00 00 00 00 00 00 00
09 04 01 06 01 02 06 02 01 06 01 02 06 02 01 09 09 04 01 06 01 02 06 00 00 00 00 00 00 00 00 00
09 03 02 01 02 01 02 01 02 01 02 01 02 01 02 09 09 03 02 01 02 01 02 00 00 00 00 00 00 00 00 00
07 08 07 02 07 08 08 08 08 08 08 07 01 07 08 07 07 08 07 02 07 08 08 00 00 00 00 00 00 00 00 00
10 10 10 01 10 10 10 10 10 10 10 10 02 10 10 37 38 10 10 01 10 10 10 00 00 00 00 00 00 00 00 00
11 11 11 02 11 33 33 33 33 33 33 11 01 11 11 11 11 11 11 02 11 33 33 00 00 00 00 00 00 00 00 00
36 13 13 16 13 34 34 34 34 34 34 13 16 13 13 13 13 13 13 16 13 34 34 00 00 00 00 00 00 00 00 00
36 12 12 12 12 12 12 12 12 12 12 12 12 12 12 12 12 12 12 12 12 12 12 00 00 00 00 00 00 00 00 00
36 12 12 12 12 12 12 12 12 12 12 12 12 12 12 12 12 12 12 12 12 12 12 00 00 00 00 00 00 00 00 00
36 12 12 16 12 35 35 35 35 35 35 12 16 12 12 12 12 12 12 16 12 35 35 00 00 00 00 00 00 00 00 00
07 08 07 01 07 08 08 08 08 08 08 07 01 07 08 08 08 08 07 01 07 08 08 00 00 00 00 00 00 00 00 00
00 00 00 00 00 00 00 00 00 00 00 00 00 00 00 00 00 00 00 00 00 00 00 00 00 00 00 00 00 00 00 00
00 00 00 00 00 00 00 00 00 00 00 00 00 00 00 00 00 00 00 00 00 00 00 00 00 00 00 00 00 00 00 00
00 00 00 00 00 00 00 00 00 00 00 00 00 00 00 00 00 00 00 00 00 00 00 00 00 00 00 00 00 00 00 00
00 00 00 00 00 00 00 00 00 00 00 00 00 00 00 00 00 00 00 00 00 00 00 00 00 00 00 00 00 00 00 00
00 00 00 00 00 00 00 00 00 00 00 00 00 00 00 00 00 00 00 00 00 00 00 00 00 00 00 00 00 00 00 00
00 00 00 00 00 00 00 00 00 00 00 00 00 00 00 00 00 00 00 00 00 00 00 00 00 00 00 00 00 00 00 00
00 00 00 00 00 00 00 00 00 00 00 00 00 00 00 00 00 00 00 00 00 00 00 00 00 00 00 00 00 00 00 00
00 00 00 00 00 00 00 00 00 00 00 00 00 00 00 00 00 00 00 00 00 00 00 00 00 00 00 00 00 00 00 00