09 10 10 10 10 10 27 28 28 29 10 10 10 10 10 09 00 00 00 00 00 00 00 00 00 00 00 00 00 00 00 00
09 11 11 11 11 11 30 31 31 32 11 11 11 11 11 09 00 00 00 00 00 00 00 00 00 00 00 00 00 00 00 00
09 04 03 04 03 04 03 04 03 04 03 04 03 04 03 09 00 00 00 00 00 00 00 00 00 00 00 00 00 00 00 00
09 03 02 01 02 01 02 01 02 01 02 01 02 01 02 09 00 00 00 00 00 00 00 00 00 00 00 00 00 00 00 00
09 04 01 05 01 02 05 02 01 05 01 02 05 02 01 09 00 00 00 00 00 00 00 00 00 00 00 00 00 00 00 00
09 03 02 06 02 01 06 01 02 06 02 01 06 01 02 09 00 00 00 00 00 00 00 00 00 00 00 00 00 00 00 00
09 04 01 02 01 02 01 02 01 02 01 02 01 02 01 09 00 00 00 00 00 00 00 00 00 00 00 00 00 00 00 00
09 03 02 05 02 01 05 01 02 05 02 01 05 01 02 09 00 00 00 00 00 00 00 00 00 00 00 00 00 00 00 00
09 04 01 06 01 02 06 02 01 06 01 02 06 02 01 09 00 00 00 00 00 00 00 00 00 00 00 00 00 00 00 00
09 03 02 01 02 01 02 01 02 01 02 01 02 01 02 09 00 00 00 00 00 00 00 00 00 00 00 00 00 00 00 00
09 04 01 05 01 02 05 02 01 05 01 02 05 02 01 09 00 00 00 00 00 00 00 00 00 00 00 00 00 00 00 00
09 03 02 06 02 01 06 01 02 06 02 01 06 01 02 09 00 00 00 00 00 00 00 00 00 00 00 00 00 00 00 00
09 04 01 02 01 02 01 02 01 02 01 02 01 02 01 09 00 00 00 00 00 00 00 00 00 00 00 00 00 00 00 00
09 03 02 05 02 01 05 01 02 05 02 01 05 01 02 09 00 00 00 00 00 00 00 00 00 00 00 00 00 00 00 00
09 04 01 06 01 02 06 02 01 06 01 02 06 02 01 09 00 00 00 00 00 00 00 00 00 00 00 00 00 00 00 00
09 03 02 01 02 01 02 01 02 01 02 01 02 01 02 09 00 00 00 00 00 00 00 00 00 00 00 00 00 00 00 00
07 08 07 02 07 08 08 08 08 08 08 07 01 07 08 07 00 00 00 00 00 00 00 00 00 00 00 00 00 00 00 00
38 10 10 01 10 10 10 10 10 10 10 10 02 10 10 10 00 00 00 00 00 00 00 00 00 00 00 00 00 00 00 00
11 11 11 02 11 33 33 33 33 33 33 11 01 11 11 11 00 00 00 00 00 00 00 00 00 00 00 00 00 00 00 00
13 13 13 16 13 34 34 34 34 34 34 13 16 17 18 19 00 00 00 00 00 00 00 00 00 00 00 00 00 00 00 00
13 12 12 12 12 12 12 12 12 12 12 12 12 20 21 22 00 00 00 00 00 00 00 00 00 00 00 00 00 00 00 00
13 12 12 12 12 12 12 12 12 12 12 12 12 20 21 22 00 00 00 00 00 00 00 00 00 00 00 00 00 00 00 00
13 12 12 12 12 12 12 12 12 12 12 12 12 23 24 25 00 00 00 00 00 00 00 00 00 00 00 00 00 00 00 00
08 08 08 08 08 08 08 08 08 08 08 08 08 08 08 08 00 00 00 00 00 00 00 00 00 00 00 00 00 00 00 00
00 00 00 00 00 00 00 00 00 00 00 00 00 00 00 00 00 00 00 00 00 00 00 00 00 00 00 00 00 00 00 00
00 00 00 00 00 00 00 00 00 00 00 00 00 00 00 00 00 00 00 00 00 00 00 00 00 00 00 00 00 00 00 00
00 00 00 00 00 00 00 00 00 00 00 00 00 00 00 00 00 00 00 00 00 00 00 00 00 00 00 00 00 00 00 00
00 00 00 00 00 00 00 00 00 00 00 00 00 00 00 00 00 00 00 00 00 00 00 00 00 00 00 00 00 00 00 00
00 00 00 00 00 00 00 00 00 00 00 00 00 00 00 00 00 00 00 00 00 00 00 00 00 00 00 00 00 00 00 00
00 00 00 00 00 00 00 00 00 00 00 00 00 00 00 00 00 00 00 00 00 00 00 00 00 00 00 00 00 00 00 00
00 00 00 00 00 00 00 00 00 00 00 00 00 00 00 00 00 00 00 00 00 00 00 00 00 00 00 00 00 00 00 00
00 00 00 00 00 00 00 00 00 00 00 00 00 00 00 00 00 00 00 00 00 00 00 00 00 00 00 00 00 00 00 00