09 10 10 04 10 10 27 28 28 29 10 10 03 10 10 09 00 00 00 00 00 00 00 00 00 00 00 00 00 00 00 00
09 11 11 03 11 11 30 31 31 32 11 11 04 11 11 09 00 00 00 00 00 00 00 00 00 00 00 00 00 00 00 00
09 04 03 04 03 04 03 04 03 04 03 04 03 04 03 09 00 00 00 00 00 00 00 00 00 00 00 00 00 00 00 00
09 03 02 01 02 01 02 01 02 01 02 01 02 01 02 09 00 00 00 00 00 00 00 00 00 00 00 00 00 00 00 00
09 04 01 05 01 02 05 02 01 05 01 02 05 02 01 09 00 00 00 00 00 00 00 00 00 00 00 00 00 00 00 00
09 03 02 06 02 01 06 01 02 06 02 01 06 01 02 09 00 00 00 00 00 00 00 00 00 00 00 00 00 00 00 00
09 04 01 02 01 02 01 02 01 02 01 02 01 02 01 09 00 00 00 00 00 00 00 00 00 00 00 00 00 00 00 00
09 03 02 05 02 01 05 01 02 05 02 01 05 01 02 09 00 00 00 00 00 00 00 00 00 00 00 00 00 00 00 00
09 04 01 06 01 02 06 02 01 06 01 02 06 02 01 09 00 00 00 00 00 00 00 00 00 00 00 00 00 00 00 00
09 03 02 01 02 01 02 01 02 01 02 01 02 01 02 09 00 00 00 00 00 00 00 00 00 00 00 00 00 00 00 00
09 04 01 05 01 02 05 02 01 05 01 02 05 02 01 09 00 00 00 00 00 00 00 00 00 00 00 00 00 00 00 00
09 03 02 06 02 01 06 01 02 06 02 01 06 01 02 09 00 00 00 00 00 00 00 00 00 00 00 00 00 00 00 00
09 04 01 02 01 02 01 02 01 02 01 02 01 02 01 09 00 00 00 00 00 00 00 00 00 00 00 00 00 00 00 00
09 03 02 05 02 01 05 01 02 05 02 01 05 01 02 09 00 00 00 00 00 00 00 00 00 00 00 00 00 00 00 00
09 04 01 06 01 02 06 02 01 06 01 02 06 02 01 09 00 00 00 00 00 00 00 00 00 00 00 00 00 00 00 00
09 03 02 01 02 01 02 01 02 01 02 01 02 01 02 09 00 00 00 00 00 00 00 00 00 00 00 00 00 00 00 00
07 08 08 08 08 08 08 08 08 08 08 08 08 08 08 07 00 00 00 00 00 00 00 00 00 00 00 00 00 00 00 00
00 00 00 00 00 00 00 00 00 00 00 00 00 00 00 00 00 00 00 00 00 00 00 00 00 00 00 00 00 00 00 00
00 00 00 00 00 00 00 00 00 00 00 00 00 00 00 00 00 00 00 00 00 00 00 00 00 00 00 00 00 00 00 00
00 00 00 00 00 00 00 00 00 00 00 00 00 00 00 00 00 00 00 00 00 00 00 00 00 00 00 00 00 00 00 00
00 00 00 00 00 00 00 00 00 00 00 00 00 00 00 00 00 00 00 00 00 00 00 00 00 00 00 00 00 00 00 00
00 00 00 00 00 00 00 00 00 00 00 00 00 00 00 00 00 00 00 00 00 00 00 00 00 00 00 00 00 00 00 00
00 00 00 00 00 00 00 00 00 00 00 00 00 00 00 00 00 00 00 00 00 00 00 00 00 00 00 00 00 00 00 00
00 00 00 00 00 00 00 00 00 00 00 00 00 00 00 00 00 00 00 00 00 00 00 00 00 00 00 00 00 00 00 00
00 00 00 00 00 00 00 00 00 00 00 00 00 00 00 00 00 00 00 00 00 00 00 00 00 00 00 00 00 00 00 00
00 00 00 00 00 00 00 00 00 00 00 00 00 00 00 00 00 00 00 00 00 00 00 00 00 00 00 00 00 00 00 00
00 00 00 00 00 00 00 00 00 00 00 00 00 00 00 00 00 00 00 00 00 00 00 00 00 00 00 00 00 00 00 00
00 00 00 00 00 00 00 00 00 00 00 00 00 00 00 00 00 00 00 00 00 00 00 00 00 00 00 00 00 00 00 00
00 00 00 00 00 00 00 00 00 00 00 00 00 00 00 00 00 00 00 00 00 00 00 00 00 00 00 00 00 00 00 00
00 00 00 00 00 00 00 00 00 00 00 00 00 00 00 00 00 00 00 00 00 00 00 00 00 00 00 00 00 00 00 00
00 00 00 00 00 00 00 00 00 00 00 00 00 00 00 00 00 00 00 00 00 00 00 00 00 00 00 00 00 00 00 00
00 00 00 00 00 00 00 00 00 00 00 00 00 00 00 00 00 00 00 00 00 00 00 00 00 00 00 00 00 00 00 00